deputy_id,year,timestamp,presencas,ausencias_justificadas,ausencias_nao_justificadas,total_dias,taxa_presenca
220593,2024,2025-02-19 11:40:22.70847,60,25,2,87,68.97
204379,2024,2025-02-19 11:40:22.70847,75,5,7,87,86.21
220714,2024,2025-02-19 11:40:22.70847,85,1,1,87,97.7
221328,2024,2025-02-19 11:40:22.70847,82,0,1,83,98.8
204560,2024,2025-02-19 11:40:22.70847,70,17,0,87,80.46
204528,2024,2025-02-19 11:40:22.70847,87,0,0,87,100.0
121948,2024,2025-02-19 11:40:22.70847,82,3,2,87,94.25
74646,2024,2025-02-19 11:40:22.70847,69,18,0,87,79.31
160508,2024,2025-02-19 11:40:22.70847,2,0,2,4,50.0
136811,2024,2025-02-19 11:40:22.70847,80,7,0,87,91.95
178835,2024,2025-02-19 11:40:22.70847,85,2,0,87,97.7
160527,2024,2025-02-19 11:40:22.70847,80,7,0,87,91.95
204495,2024,2025-02-19 11:40:22.70847,80,0,7,87,91.95
204549,2024,2025-02-19 11:40:22.70847,70,12,5,87,80.46
73579,2024,2025-02-19 11:40:22.70847,85,1,1,87,97.7
74696,2024,2025-02-19 11:40:22.70847,58,18,11,87,66.67
220538,2024,2025-02-19 11:40:22.70847,74,13,0,87,85.06
160559,2024,2025-02-19 11:40:22.70847,81,5,1,87,93.1
204501,2024,2025-02-19 11:40:22.70847,87,0,0,87,100.0
178972,2024,2025-02-19 11:40:22.70847,86,1,0,87,98.85
204571,2024,2025-02-19 11:40:22.70847,86,0,1,87,98.85
220542,2024,2025-02-19 11:40:22.70847,72,15,0,87,82.76
160545,2024,2025-02-19 11:40:22.70847,85,2,0,87,97.7
220554,2024,2025-02-19 11:40:22.70847,82,4,1,87,94.25
204503,2024,2025-02-19 11:40:22.70847,0,0,0,0,
221148,2024,2025-02-19 11:40:22.70847,87,0,0,87,100.0
220576,2024,2025-02-19 11:40:22.70847,87,0,0,87,100.0
74057,2024,2025-02-19 11:40:22.70847,84,3,0,87,96.55
178927,2024,2025-02-19 11:40:22.70847,71,10,6,87,81.61
226708,2024,2025-02-19 11:40:22.70847,79,4,1,84,94.05
178937,2024,2025-02-19 11:40:22.70847,75,12,0,87,86.21
178881,2024,2025-02-19 11:40:22.70847,68,3,0,71,95.77
220596,2024,2025-02-19 11:40:22.70847,22,4,0,26,84.62
220707,2024,2025-02-19 11:40:22.70847,54,0,0,54,100.0
204356,2024,2025-02-19 11:40:22.70847,87,0,0,87,100.0
220715,2024,2025-02-19 11:40:22.70847,83,3,1,87,95.4
107970,2024,2025-02-19 11:40:22.70847,81,6,0,87,93.1
220556,2024,2025-02-19 11:40:22.70847,86,0,1,87,98.85
220632,2024,2025-02-19 11:40:22.70847,86,1,0,87,98.85
220657,2024,2025-02-19 11:40:22.70847,53,0,4,57,92.98
204423,2024,2025-02-19 11:40:22.70847,64,23,0,87,73.56
133439,2024,2025-02-19 11:40:22.70847,87,0,0,87,100.0
178882,2024,2025-02-19 11:40:22.70847,2,0,1,3,66.67
204515,2024,2025-02-19 11:40:22.70847,85,2,0,87,97.7
220676,2024,2025-02-19 11:40:22.70847,61,25,1,87,70.11
123756,2024,2025-02-19 11:40:22.70847,79,0,8,87,90.8
220544,2024,2025-02-19 11:40:22.70847,87,0,0,87,100.0
160553,2024,2025-02-19 11:40:22.70847,87,0,0,87,100.0
220638,2024,2025-02-19 11:40:22.70847,87,0,0,87,100.0
220675,2024,2025-02-19 11:40:22.70847,78,7,2,87,89.66
220549,2024,2025-02-19 11:42:43.361114,82,5,0,87,94.25
73433,2024,2025-02-19 11:42:43.361114,87,0,0,87,100.0
141391,2024,2025-02-19 11:42:43.361114,84,3,0,87,96.55
160541,2024,2025-02-19 11:42:43.361114,84,3,0,87,96.55
160600,2024,2025-02-19 11:42:43.361114,68,18,1,87,78.16
74090,2024,2025-02-19 11:42:43.361114,83,2,2,87,95.4
123086,2024,2025-02-19 11:42:43.361114,84,2,1,87,96.55
160665,2024,2025-02-19 11:42:43.361114,82,1,4,87,94.25
220577,2024,2025-02-19 11:42:43.361114,76,8,3,87,87.36
160512,2024,2025-02-19 11:42:43.361114,0,0,0,0,
69871,2024,2025-02-19 11:42:43.361114,80,3,4,87,91.95
178975,2024,2025-02-19 11:42:43.361114,71,16,0,87,81.61
220605,2024,2025-02-19 11:42:43.361114,84,3,0,87,96.55
220612,2024,2025-02-19 11:42:43.361114,87,0,0,87,100.0
73701,2024,2025-02-19 11:42:43.361114,81,5,1,87,93.1
109429,2024,2025-02-19 11:42:43.361114,87,0,0,87,100.0
204358,2024,2025-02-19 11:42:43.361114,85,2,0,87,97.7
220698,2024,2025-02-19 11:42:43.361114,34,1,1,36,94.44
220683,2024,2025-02-19 11:42:43.361114,81,6,0,87,93.1
204374,2024,2025-02-19 11:42:43.361114,82,5,0,87,94.25
204388,2024,2025-02-19 11:42:43.361114,86,1,0,87,98.85
160538,2024,2025-02-19 11:42:43.361114,86,1,0,87,98.85
74052,2024,2025-02-19 11:42:43.361114,23,0,0,23,100.0
210989,2024,2025-02-19 11:42:43.361114,75,12,0,87,86.21
220635,2024,2025-02-19 11:42:43.361114,82,5,0,87,94.25
220574,2024,2025-02-19 11:42:43.361114,87,0,0,87,100.0
143942,2024,2025-02-19 11:42:43.361114,16,0,0,16,100.0
220548,2024,2025-02-19 11:42:43.361114,82,1,4,87,94.25
204572,2024,2025-02-19 11:42:43.361114,83,1,3,87,95.4
220690,2024,2025-02-19 11:42:43.361114,84,2,1,87,96.55
178829,2024,2025-02-19 11:42:43.361114,87,0,0,87,100.0
229069,2024,2025-02-19 11:42:43.361114,24,0,0,24,100.0
229106,2024,2025-02-19 11:42:43.361114,23,0,0,23,100.0
213762,2024,2025-02-19 11:42:43.361114,0,0,0,0,
204507,2024,2025-02-19 11:42:43.361114,84,3,0,87,96.55
204361,2024,2025-02-19 11:42:43.361114,57,4,5,66,86.36
178962,2024,2025-02-19 11:42:43.361114,4,0,0,4,100.0
178993,2024,2025-02-19 11:42:43.361114,85,0,2,87,97.7
204460,2024,2025-02-19 11:42:43.361114,50,4,0,54,92.59
74262,2024,2025-02-19 11:42:43.361114,79,8,0,87,90.8
204426,2024,2025-02-19 11:42:43.361114,87,0,0,87,100.0
141398,2024,2025-02-19 11:42:43.361114,84,2,1,87,96.55
164360,2024,2025-02-19 11:42:43.361114,50,2,1,53,94.34
220704,2024,2025-02-19 11:42:43.361114,78,7,2,87,89.66
204369,2024,2025-02-19 11:42:43.361114,85,1,1,87,97.7
220699,2024,2025-02-19 11:42:43.361114,82,5,0,87,94.25
206018,2024,2025-02-19 11:42:43.361114,72,10,5,87,82.76
178876,2024,2025-02-19 11:42:43.361114,78,9,0,87,89.66
204488,2024,2025-02-19 11:42:43.361114,72,0,9,81,88.89
73441,2024,2025-02-19 11:42:43.361114,86,1,0,87,98.85
204496,2024,2025-02-19 11:45:00.071742,3,0,0,3,100.0
204504,2024,2025-02-19 11:45:00.071742,80,0,7,87,91.95
205476,2024,2025-02-19 11:45:00.071742,82,0,1,83,98.8
74171,2024,2025-02-19 11:45:00.071742,87,0,0,87,100.0
204476,2024,2025-02-19 11:45:00.071742,12,2,73,87,13.79
204462,2024,2025-02-19 11:45:00.071742,85,1,1,87,97.7
220665,2024,2025-02-19 11:45:00.071742,58,2,2,62,93.55
74537,2024,2025-02-19 11:45:00.071742,81,6,0,87,93.1
141408,2024,2025-02-19 11:45:00.071742,81,5,1,87,93.1
88256,2024,2025-02-19 11:45:00.071742,78,8,1,87,89.66
98148,2024,2025-02-19 11:45:00.071742,87,0,0,87,100.0
220594,2024,2025-02-19 11:45:00.071742,87,0,0,87,100.0
204378,2024,2025-02-19 11:45:00.071742,85,0,2,87,97.7
220595,2024,2025-02-19 11:45:00.071742,75,12,0,87,86.21
220666,2024,2025-02-19 11:45:00.071742,87,0,0,87,100.0
222142,2024,2025-02-19 11:45:00.071742,47,0,0,47,100.0
220590,2024,2025-02-19 11:45:00.071742,84,3,0,87,96.55
178963,2024,2025-02-19 11:45:00.071742,79,4,4,87,90.8
220608,2024,2025-02-19 11:45:00.071742,87,0,0,87,100.0
204355,2024,2025-02-19 11:45:00.071742,83,2,2,87,95.4
141411,2024,2025-02-19 11:45:00.071742,79,8,0,87,90.8
220555,2024,2025-02-19 11:45:00.071742,80,7,0,87,91.95
220692,2024,2025-02-19 11:45:00.071742,77,5,5,87,88.51
74467,2024,2025-02-19 11:45:00.071742,77,6,4,87,88.51
220629,2024,2025-02-19 11:45:00.071742,83,1,3,87,95.4
220603,2024,2025-02-19 11:45:00.071742,74,13,0,87,85.06
220571,2024,2025-02-19 11:45:00.071742,87,0,0,87,100.0
74060,2024,2025-02-19 11:45:00.071742,86,0,1,87,98.85
220582,2024,2025-02-19 11:45:00.071742,74,4,9,87,85.06
204367,2024,2025-02-19 11:45:00.071742,79,4,4,87,90.8
228941,2024,2025-02-19 11:45:00.071742,25,0,1,26,96.15
220614,2024,2025-02-19 11:45:00.071742,30,0,0,30,100.0
204409,2024,2025-02-19 11:45:00.071742,86,0,1,87,98.85
204459,2024,2025-02-19 11:45:00.071742,83,0,4,87,95.4
220557,2024,2025-02-19 11:45:00.071742,86,1,0,87,98.85
62881,2024,2025-02-19 11:45:00.071742,79,5,3,87,90.8
160552,2024,2025-02-19 11:45:00.071742,14,5,4,23,60.87
116379,2024,2025-02-19 11:45:00.071742,54,1,3,58,93.1
204511,2024,2025-02-19 11:45:00.071742,77,8,2,87,88.51
220659,2024,2025-02-19 11:45:00.071742,83,3,1,87,95.4
220539,2024,2025-02-19 11:45:00.071742,77,8,2,87,88.51
220565,2024,2025-02-19 11:45:00.071742,80,7,0,87,91.95
220625,2024,2025-02-19 11:45:00.071742,71,16,0,87,81.61
220561,2024,2025-02-19 11:45:00.071742,86,1,0,87,98.85
220642,2024,2025-02-19 11:45:00.071742,40,0,0,40,100.0
220673,2024,2025-02-19 11:45:00.071742,86,0,1,87,98.85
220649,2024,2025-02-19 11:45:00.071742,77,10,0,87,88.51
178908,2024,2025-02-19 11:45:00.071742,81,1,5,87,93.1
220583,2024,2025-02-19 11:45:00.071742,87,0,0,87,100.0
204512,2024,2025-02-19 11:45:00.071742,81,6,0,87,93.1
220701,2024,2025-02-19 11:47:14.615543,82,5,0,87,94.25
220652,2024,2025-02-19 11:47:14.615543,87,0,0,87,100.0
220654,2024,2025-02-19 11:47:14.615543,87,0,0,87,100.0
220619,2024,2025-02-19 11:47:14.615543,86,0,1,87,98.85
228272,2024,2025-02-19 11:47:14.615543,28,2,1,31,90.32
220705,2024,2025-02-19 11:47:14.615543,0,0,0,0,
220553,2024,2025-02-19 11:47:14.615543,81,2,4,87,93.1
220689,2024,2025-02-19 11:47:14.615543,57,9,5,71,80.28
160588,2024,2025-02-19 11:47:14.615543,80,2,5,87,91.95
220691,2024,2025-02-19 11:47:14.615543,82,4,1,87,94.25
178929,2024,2025-02-19 11:47:14.615543,80,7,0,87,91.95
73768,2024,2025-02-19 11:47:14.615543,86,0,1,87,98.85
220671,2024,2025-02-19 11:47:14.615543,84,2,1,87,96.55
160599,2024,2025-02-19 11:47:14.615543,80,7,0,87,91.95
220602,2024,2025-02-19 11:47:14.615543,86,1,0,87,98.85
143632,2024,2025-02-19 11:47:14.615543,65,22,0,87,74.71
160758,2024,2025-02-19 11:47:14.615543,82,4,1,87,94.25
220573,2024,2025-02-19 11:47:14.615543,80,4,3,87,91.95
227433,2024,2025-02-19 11:47:14.615543,85,0,1,86,98.84
204450,2024,2025-02-19 11:47:14.615543,46,41,0,87,52.87
221339,2024,2025-02-19 11:47:14.615543,80,2,5,87,91.95
227401,2024,2025-02-19 11:47:14.615543,16,1,1,18,88.89
227991,2024,2025-02-19 11:47:14.615543,32,0,0,32,100.0
220610,2024,2025-02-19 11:47:14.615543,80,7,0,87,91.95
220688,2024,2025-02-19 11:47:14.615543,87,0,0,87,100.0
204518,2024,2025-02-19 11:47:14.615543,81,4,2,87,93.1
212625,2024,2025-02-19 11:47:14.615543,23,0,1,24,95.83
220570,2024,2025-02-19 11:47:14.615543,77,10,0,87,88.51
204481,2024,2025-02-19 11:47:14.615543,84,1,2,87,96.55
204351,2024,2025-02-19 11:47:14.615543,84,3,0,87,96.55
228616,2024,2025-02-19 11:47:14.615543,31,0,1,32,96.88
220528,2024,2025-02-19 11:47:14.615543,78,4,5,87,89.66
204412,2024,2025-02-19 11:47:14.615543,83,4,0,87,95.4
220674,2024,2025-02-19 11:47:14.615543,70,14,3,87,80.46
230088,2024,2025-02-19 11:47:14.615543,26,2,0,28,92.86
220686,2024,2025-02-19 11:47:14.615543,87,0,0,87,100.0
227800,2024,2025-02-19 11:47:14.615543,34,1,0,35,97.14
220540,2024,2025-02-19 11:47:14.615543,74,9,4,87,85.06
220623,2024,2025-02-19 11:47:14.615543,70,17,0,87,80.46
204541,2024,2025-02-19 11:47:14.615543,84,0,3,87,96.55
92346,2024,2025-02-19 11:47:14.615543,72,13,2,87,82.76
141421,2024,2025-02-19 11:47:14.615543,76,10,1,87,87.36
220589,2024,2025-02-19 11:47:14.615543,66,3,0,69,95.65
74075,2024,2025-02-19 11:47:14.615543,62,22,3,87,71.26
204364,2024,2025-02-19 11:47:14.615543,59,0,2,61,96.72
226553,2024,2025-02-19 11:47:14.615543,0,0,0,0,
229585,2024,2025-02-19 11:47:14.615543,24,0,1,25,96.0
220008,2024,2025-02-19 11:47:14.615543,24,0,1,25,96.0
178854,2024,2025-02-19 11:47:14.615543,69,18,0,87,79.31
218086,2024,2025-02-19 11:47:14.615543,83,4,0,87,95.4
198783,2024,2025-02-19 11:49:30.28591,80,0,7,87,91.95
161550,2024,2025-02-19 11:49:30.28591,76,11,0,87,87.36
225730,2024,2025-02-19 11:49:30.28591,0,0,0,0,
230765,2024,2025-02-19 11:49:30.28591,0,0,0,0,
132504,2024,2025-02-19 11:49:30.28591,0,0,0,0,
220663,2024,2025-02-19 11:49:30.28591,86,1,0,87,98.85
220645,2024,2025-02-19 11:49:30.28591,67,20,0,87,77.01
160575,2024,2025-02-19 11:49:30.28591,85,2,0,87,97.7
160640,2024,2025-02-19 11:49:30.28591,80,7,0,87,91.95
204482,2024,2025-02-19 11:49:30.28591,47,1,3,51,92.16
74454,2024,2025-02-19 11:49:30.28591,86,0,1,87,98.85
178871,2024,2025-02-19 11:49:30.28591,83,3,1,87,95.4
178905,2024,2025-02-19 11:49:30.28591,1,0,0,1,100.0
68720,2024,2025-02-19 11:49:30.28591,22,0,0,22,100.0
220681,2024,2025-02-19 11:49:30.28591,53,1,9,63,84.13
171623,2024,2025-02-19 11:49:30.28591,6,0,2,8,75.0
204368,2024,2025-02-19 11:49:30.28591,85,2,0,87,97.7
220653,2024,2025-02-19 11:49:30.28591,86,0,1,87,98.85
66828,2024,2025-02-19 11:49:30.28591,77,9,1,87,88.51
220712,2024,2025-02-19 11:49:30.28591,16,3,2,21,76.19
220646,2024,2025-02-19 11:49:30.28591,1,0,0,1,100.0
72442,2024,2025-02-19 11:49:30.28591,73,8,6,87,83.91
204398,2024,2025-02-19 11:49:30.28591,81,5,1,87,93.1
227370,2024,2025-02-19 11:49:30.28591,18,0,0,18,100.0
160666,2024,2025-02-19 11:49:30.28591,81,4,2,87,93.1
204407,2024,2025-02-19 11:49:30.28591,56,31,0,87,64.37
220656,2024,2025-02-19 11:49:30.28591,83,4,0,87,95.4
141431,2024,2025-02-19 11:49:30.28591,81,2,4,87,93.1
204445,2024,2025-02-19 11:49:30.28591,87,0,0,87,100.0
92699,2024,2025-02-19 11:49:30.28591,81,5,1,87,93.1
204427,2024,2025-02-19 11:49:30.28591,75,9,3,87,86.21
204411,2024,2025-02-19 11:49:30.28591,50,37,0,87,57.47
220545,2024,2025-02-19 11:49:30.28591,87,0,0,87,100.0
160598,2024,2025-02-19 11:49:30.28591,80,7,0,87,91.95
225727,2024,2025-02-19 11:49:30.28591,0,0,0,0,
191923,2024,2025-02-19 11:49:30.28591,83,2,2,87,95.4
220700,2024,2025-02-19 11:49:30.28591,80,6,1,87,91.95
220551,2024,2025-02-19 11:49:30.28591,76,10,1,87,87.36
204494,2024,2025-02-19 11:49:30.28591,52,17,0,69,75.36
220534,2024,2025-02-19 11:49:30.28591,84,1,2,87,96.55
224117,2024,2025-02-19 11:49:30.28591,83,3,1,87,95.4
220708,2024,2025-02-19 11:49:30.28591,87,0,0,87,100.0
204473,2024,2025-02-19 11:49:30.28591,86,1,0,87,98.85
220611,2024,2025-02-19 11:49:30.28591,83,4,0,87,95.4
178966,2024,2025-02-19 11:49:30.28591,34,1,0,35,97.14
220702,2024,2025-02-19 11:49:30.28591,38,12,2,52,73.08
74374,2024,2025-02-19 11:49:30.28591,83,1,3,87,95.4
220587,2024,2025-02-19 11:49:30.28591,87,0,0,87,100.0
204394,2024,2025-02-19 11:49:30.28591,85,2,0,87,97.7
74383,2024,2025-02-19 11:49:30.28591,79,5,3,87,90.8
204491,2024,2025-02-19 11:51:41.282064,87,0,0,87,100.0
74270,2024,2025-02-19 11:51:41.282064,65,22,0,87,74.71
220529,2024,2025-02-19 11:51:41.282064,87,0,0,87,100.0
204365,2024,2025-02-19 11:51:41.282064,87,0,0,87,100.0
220526,2024,2025-02-19 11:51:41.282064,84,3,0,87,96.55
220531,2024,2025-02-19 11:51:41.282064,81,2,4,87,93.1
160673,2024,2025-02-19 11:51:41.282064,86,1,0,87,98.85
226179,2024,2025-02-19 11:51:41.282064,84,2,0,86,97.67
152605,2024,2025-02-19 11:51:41.282064,80,6,1,87,91.95
229333,2024,2025-02-19 11:51:41.282064,24,0,0,24,100.0
204419,2024,2025-02-19 11:51:41.282064,80,4,3,87,91.95
107283,2024,2025-02-19 11:51:41.282064,74,13,0,87,85.06
198197,2024,2025-02-19 11:51:41.282064,75,11,1,87,86.21
220639,2024,2025-02-19 11:51:41.282064,77,5,5,87,88.51
204531,2024,2025-02-19 11:51:41.282064,4,0,0,4,100.0
220664,2024,2025-02-19 11:51:41.282064,81,5,1,87,93.1
220568,2024,2025-02-19 11:51:41.282064,82,2,3,87,94.25
204408,2024,2025-02-19 11:51:41.282064,85,0,2,87,97.7
204456,2024,2025-02-19 11:51:41.282064,77,8,2,87,88.51
178964,2024,2025-02-19 11:51:41.282064,80,6,1,87,91.95
178873,2024,2025-02-19 11:51:41.282064,87,0,0,87,100.0
220537,2024,2025-02-19 11:51:41.282064,68,17,2,87,78.16
178909,2024,2025-02-19 11:51:41.282064,70,13,1,84,83.33
204444,2024,2025-02-19 11:51:41.282064,83,3,1,87,95.4
220672,2024,2025-02-19 11:51:41.282064,79,2,6,87,90.8
227324,2024,2025-02-19 11:51:41.282064,14,1,1,16,87.5
204539,2024,2025-02-19 11:51:41.282064,51,33,3,87,58.62
100689,2024,2025-02-19 11:51:41.282064,18,0,0,18,100.0
178884,2024,2025-02-19 11:51:41.282064,32,0,0,32,100.0
141450,2024,2025-02-19 11:51:41.282064,87,0,0,87,100.0
160674,2024,2025-02-19 11:51:41.282064,66,21,0,87,75.86
220563,2024,2025-02-19 11:51:41.282064,56,7,1,64,87.5
204533,2024,2025-02-19 11:51:41.282064,80,5,2,87,91.95
204508,2024,2025-02-19 11:51:41.282064,87,0,0,87,100.0
98615,2024,2025-02-19 11:51:41.282064,80,6,1,87,91.95
204436,2024,2025-02-19 11:51:41.282064,52,35,0,87,59.77
230764,2024,2025-02-19 11:51:41.282064,0,0,0,0,
73531,2024,2025-02-19 11:51:41.282064,86,1,0,87,98.85
220696,2024,2025-02-19 11:51:41.282064,84,3,0,87,96.55
220670,2024,2025-02-19 11:51:41.282064,71,16,0,87,81.61
220527,2024,2025-02-19 11:51:41.282064,87,0,0,87,100.0
220697,2024,2025-02-19 11:51:41.282064,79,4,4,87,90.8
74848,2024,2025-02-19 11:51:41.282064,0,0,0,0,
220567,2024,2025-02-19 11:51:41.282064,60,9,0,69,86.96
74273,2024,2025-02-19 11:51:41.282064,82,5,0,87,94.25
160531,2024,2025-02-19 11:51:41.282064,0,0,0,0,
141456,2024,2025-02-19 11:51:41.282064,86,1,0,87,98.85
141458,2024,2025-02-19 11:51:41.282064,84,3,0,87,96.55
230957,2024,2025-02-19 11:51:41.282064,0,0,0,0,
178970,2024,2025-02-19 11:51:41.282064,87,0,0,87,100.0
74550,2024,2025-02-19 11:53:50.288292,78,6,3,87,89.66
141459,2024,2025-02-19 11:53:50.288292,79,6,2,87,90.8
178910,2024,2025-02-19 11:53:50.288292,87,0,0,87,100.0
160548,2024,2025-02-19 11:53:50.288292,84,3,0,87,96.55
217480,2024,2025-02-19 11:53:50.288292,0,0,0,0,
205550,2024,2025-02-19 11:53:50.288292,83,4,0,87,95.4
214694,2024,2025-02-19 11:53:50.288292,87,0,0,87,100.0
178857,2024,2025-02-19 11:53:50.288292,84,3,0,87,96.55
141464,2024,2025-02-19 11:53:50.288292,84,3,0,87,96.55
141470,2024,2025-02-19 11:53:50.288292,85,2,0,87,97.7
204472,2024,2025-02-19 11:53:50.288292,83,4,0,87,95.4
204391,2024,2025-02-19 11:53:50.288292,76,7,4,87,87.36
74079,2024,2025-02-19 11:53:50.288292,70,4,13,87,80.46
74554,2024,2025-02-19 11:53:50.288292,73,12,2,87,83.91
209189,2024,2025-02-19 11:53:50.288292,84,2,1,87,96.55
220578,2024,2025-02-19 11:53:50.288292,87,0,0,87,100.0
74141,2024,2025-02-19 11:53:50.288292,82,1,0,83,98.8
204563,2024,2025-02-19 11:53:50.288292,56,10,5,71,78.87
215043,2024,2025-02-19 11:53:50.288292,79,1,7,87,90.8
204474,2024,2025-02-19 11:53:50.288292,53,5,0,58,91.38
220559,2024,2025-02-19 11:53:50.288292,85,2,0,87,97.7
220640,2024,2025-02-19 11:53:50.288292,77,9,1,87,88.51
228837,2024,2025-02-19 11:53:50.288292,29,0,0,29,100.0
66385,2024,2025-02-19 11:53:50.288292,86,0,1,87,98.85
74317,2024,2025-02-19 11:53:50.288292,84,3,0,87,96.55
204372,2024,2025-02-19 11:53:50.288292,77,9,1,87,88.51
74253,2024,2025-02-19 11:53:50.288292,74,12,1,87,85.06
228797,2024,2025-02-19 11:53:50.288292,32,0,0,32,100.0
204457,2024,2025-02-19 11:53:50.288292,86,1,0,87,98.85
204520,2024,2025-02-19 11:53:50.288292,47,16,0,63,74.6
204497,2024,2025-02-19 11:53:50.288292,86,0,1,87,98.85
204574,2024,2025-02-19 11:53:50.288292,60,2,9,71,84.51
204550,2024,2025-02-19 11:53:50.288292,47,6,7,60,78.33
178886,2024,2025-02-19 11:53:50.288292,0,0,0,0,
220677,2024,2025-02-19 11:53:50.288292,84,2,1,87,96.55
162067,2024,2025-02-19 11:53:50.288292,83,2,2,87,95.4
204536,2024,2025-02-19 11:53:50.288292,80,5,2,87,91.95
98057,2024,2025-02-19 11:53:50.288292,81,6,0,87,93.1
74856,2024,2025-02-19 11:53:50.288292,87,0,0,87,100.0
141480,2024,2025-02-19 11:53:50.288292,86,1,0,87,98.85
178832,2024,2025-02-19 11:53:50.288292,0,0,1,1,0.0
220600,2024,2025-02-19 11:53:50.288292,72,12,3,87,82.76
220566,2024,2025-02-19 11:53:50.288292,72,13,2,87,82.76
80815,2024,2025-02-19 11:53:50.288292,87,0,0,87,100.0
122195,2024,2025-02-19 11:53:50.288292,25,0,0,25,100.0
74156,2024,2025-02-19 11:53:50.288292,84,2,1,87,96.55
74299,2024,2025-02-19 11:53:50.288292,37,0,2,39,94.87
92102,2024,2025-02-19 11:53:50.288292,85,0,2,87,97.7
139285,2024,2025-02-19 11:53:50.288292,83,2,2,87,95.4
74585,2024,2025-02-19 11:53:50.288292,87,0,0,87,100.0
74858,2024,2025-02-19 11:56:11.207366,82,0,5,87,94.25
171139,2024,2025-02-19 11:56:11.207366,25,6,0,31,80.65
220662,2024,2025-02-19 11:56:11.207366,86,0,1,87,98.85
204404,2024,2025-02-19 11:56:11.207366,86,1,0,87,98.85
138286,2024,2025-02-19 11:56:11.207366,46,4,1,51,90.2
220581,2024,2025-02-19 11:56:11.207366,84,2,1,87,96.55
103758,2024,2025-02-19 11:56:11.207366,58,3,3,64,90.62
74478,2024,2025-02-19 11:56:11.207366,46,41,0,87,52.87
178931,2024,2025-02-19 11:56:11.207366,81,3,3,87,93.1
227323,2024,2025-02-19 11:56:11.207366,12,3,1,16,75.0
220616,2024,2025-02-19 11:56:11.207366,75,8,4,87,86.21
178954,2024,2025-02-19 11:56:11.207366,82,5,0,87,94.25
229082,2024,2025-02-19 11:56:11.207366,22,3,0,25,88.0
222429,2024,2025-02-19 11:56:11.207366,81,2,1,84,96.43
160510,2024,2025-02-19 11:56:11.207366,61,26,0,87,70.11
204410,2024,2025-02-19 11:56:11.207366,83,4,0,87,95.4
204448,2024,2025-02-19 11:56:11.207366,0,0,0,0,
141485,2024,2025-02-19 11:56:11.207366,68,17,2,87,78.16
73778,2024,2025-02-19 11:56:11.207366,78,9,0,87,89.66
204485,2024,2025-02-19 11:56:11.207366,86,0,1,87,98.85
74041,2024,2025-02-19 11:56:11.207366,86,1,0,87,98.85
141487,2024,2025-02-19 11:56:11.207366,81,2,4,87,93.1
229432,2024,2025-02-19 11:56:11.207366,19,0,2,21,90.48
220658,2024,2025-02-19 11:56:11.207366,81,4,2,87,93.1
204455,2024,2025-02-19 11:56:11.207366,87,0,0,87,100.0
220636,2024,2025-02-19 11:56:11.207366,0,0,0,0,
162332,2024,2025-02-19 11:56:11.207366,77,10,0,87,88.51
204526,2024,2025-02-19 11:56:11.207366,80,4,3,87,91.95
74784,2024,2025-02-19 11:56:11.207366,73,13,1,87,83.91
178866,2024,2025-02-19 11:56:11.207366,0,0,0,0,
220669,2024,2025-02-19 11:56:11.207366,79,8,0,87,90.8
166402,2024,2025-02-19 11:56:11.207366,73,3,11,87,83.91
220648,2024,2025-02-19 11:56:11.207366,79,2,6,87,90.8
156190,2024,2025-02-19 11:56:11.207366,87,0,0,87,100.0
179000,2024,2025-02-19 11:56:11.207366,78,2,7,87,89.66
204433,2024,2025-02-19 11:56:11.207366,4,2,0,6,66.67
220599,2024,2025-02-19 11:56:11.207366,86,1,0,87,98.85
220634,2024,2025-02-19 11:56:11.207366,0,0,0,0,
133810,2024,2025-02-19 11:56:11.207366,73,12,2,87,83.91
160161,2024,2025-02-19 11:56:11.207366,83,4,0,87,95.4
178983,2024,2025-02-19 11:56:11.207366,87,0,0,87,100.0
179001,2024,2025-02-19 11:56:11.207366,83,3,1,87,95.4
226410,2024,2025-02-19 11:56:11.207366,0,0,0,0,
220687,2024,2025-02-19 11:56:11.207366,57,5,0,62,91.94
81055,2024,2025-02-19 11:56:11.207366,84,2,1,87,96.55
150418,2024,2025-02-19 11:56:11.207366,83,2,2,87,95.4
204522,2024,2025-02-19 11:56:11.207366,0,0,0,0,
219585,2024,2025-02-19 11:56:11.207366,83,0,3,86,96.51
160535,2024,2025-02-19 11:56:11.207366,78,5,4,87,89.66
204431,2024,2025-02-19 11:56:11.207366,74,12,1,87,85.06
204506,2024,2025-02-19 11:58:24.325678,73,14,0,87,83.91
220547,2024,2025-02-19 11:58:24.325678,87,0,0,87,100.0
178943,2024,2025-02-19 11:58:24.325678,59,27,1,87,67.82
220604,2024,2025-02-19 11:58:24.325678,74,8,5,87,85.06
220668,2024,2025-02-19 11:58:24.325678,68,19,0,87,78.16
74398,2024,2025-02-19 11:58:24.325678,75,12,0,87,86.21
204540,2024,2025-02-19 11:58:24.325678,85,2,0,87,97.7
227275,2024,2025-02-19 11:58:24.325678,14,2,0,16,87.5
220637,2024,2025-02-19 11:58:24.325678,0,0,0,0,
220655,2024,2025-02-19 11:58:24.325678,78,8,1,87,89.66
74158,2024,2025-02-19 11:58:24.325678,51,5,0,56,91.07
178858,2024,2025-02-19 11:58:24.325678,80,7,0,87,91.95
204566,2024,2025-02-19 11:58:24.325678,54,9,4,67,80.6
220572,2024,2025-02-19 11:58:24.325678,86,0,1,87,98.85
178843,2024,2025-02-19 11:58:24.325678,83,0,4,87,95.4
220661,2024,2025-02-19 11:58:24.325678,87,0,0,87,100.0
220609,2024,2025-02-19 11:58:24.325678,85,2,0,87,97.7
220628,2024,2025-02-19 11:58:24.325678,83,4,0,87,95.4
220550,2024,2025-02-19 11:58:24.325678,87,0,0,87,100.0
220647,2024,2025-02-19 11:58:24.325678,70,9,8,87,80.46
204486,2024,2025-02-19 11:58:24.325678,85,2,0,87,97.7
220607,2024,2025-02-19 11:58:24.325678,87,0,0,87,100.0
220591,2024,2025-02-19 11:58:24.325678,85,2,0,87,97.7
74428,2024,2025-02-19 11:58:24.325678,80,7,0,87,91.95
188097,2024,2025-02-19 11:58:24.325678,85,2,0,87,97.7
220585,2024,2025-02-19 11:58:24.325678,60,2,0,62,96.77
220530,2024,2025-02-19 11:58:24.325678,87,0,0,87,100.0
171786,2024,2025-02-19 11:58:24.325678,85,2,0,87,97.7
178985,2024,2025-02-19 11:58:24.325678,87,0,0,87,100.0
154178,2024,2025-02-19 11:58:24.325678,0,0,0,0,
178895,2024,2025-02-19 11:58:24.325678,86,0,1,87,98.85
229225,2024,2025-02-19 11:58:24.325678,23,1,0,24,95.83
178997,2024,2025-02-19 11:58:24.325678,80,0,7,87,91.95
220617,2024,2025-02-19 11:58:24.325678,85,1,1,87,97.7
220584,2024,2025-02-19 11:58:24.325678,85,1,1,87,97.7
204453,2024,2025-02-19 11:58:24.325678,81,6,0,87,93.1
228042,2024,2025-02-19 11:58:24.325678,6,0,0,6,100.0
204449,2024,2025-02-19 11:58:24.325678,43,14,2,59,72.88
220622,2024,2025-02-19 11:58:24.325678,85,2,0,87,97.7
220703,2024,2025-02-19 11:58:24.325678,86,1,0,87,98.85
229939,2024,2025-02-19 11:58:24.325678,34,0,0,34,100.0
178896,2024,2025-02-19 11:58:24.325678,46,3,4,53,86.79
204479,2024,2025-02-19 11:58:24.325678,81,6,0,87,93.1
209787,2024,2025-02-19 11:58:24.325678,84,3,0,87,96.55
178986,2024,2025-02-19 11:58:24.325678,85,2,0,87,97.7
227660,2024,2025-02-19 11:58:24.325678,75,3,2,80,93.75
74159,2024,2025-02-19 11:58:24.325678,86,1,0,87,98.85
204498,2024,2025-02-19 11:58:24.325678,73,9,5,87,83.91
178987,2024,2025-02-19 11:58:24.325678,83,2,2,87,95.4
73692,2024,2025-02-19 11:58:24.325678,80,5,2,87,91.95
204422,2024,2025-02-19 12:00:34.790367,84,2,1,87,96.55
204441,2024,2025-02-19 12:00:34.790367,82,3,2,87,94.25
204573,2024,2025-02-19 12:00:34.790367,79,6,2,87,90.8
220706,2024,2025-02-19 12:00:34.790367,62,24,1,87,71.26
160556,2024,2025-02-19 12:00:34.790367,86,0,1,87,98.85
230762,2024,2025-02-19 12:00:34.790367,0,0,0,0,
180214,2024,2025-02-19 12:00:34.790367,81,3,3,87,93.1
160642,2024,2025-02-19 12:00:34.790367,81,5,1,87,93.1
204570,2024,2025-02-19 12:00:34.790367,67,2,2,71,94.37
220615,2024,2025-02-19 12:00:34.790367,87,0,0,87,100.0
204553,2024,2025-02-19 12:00:34.790367,86,0,1,87,98.85
74160,2024,2025-02-19 12:00:34.790367,85,2,0,87,97.7
74095,2024,2025-02-19 12:00:34.790367,66,0,0,66,100.0
171617,2024,2025-02-19 12:00:34.790367,87,0,0,87,100.0
141518,2024,2025-02-19 12:00:34.790367,47,5,4,56,83.93
220627,2024,2025-02-19 12:00:34.790367,77,8,2,87,88.51
141516,2024,2025-02-19 12:00:34.790367,74,7,6,87,85.06
220650,2024,2025-02-19 12:00:34.790367,84,2,1,87,96.55
178860,2024,2025-02-19 12:00:34.790367,77,6,4,87,88.51
160517,2024,2025-02-19 12:00:34.790367,61,24,2,87,70.11
160558,2024,2025-02-19 12:00:34.790367,73,10,4,87,83.91
204492,2024,2025-02-19 12:00:34.790367,84,3,0,87,96.55
220685,2024,2025-02-19 12:00:34.790367,81,6,0,87,93.1
74574,2024,2025-02-19 12:00:34.790367,87,0,0,87,100.0
128760,2024,2025-02-19 12:00:34.790367,14,1,1,16,87.5
74400,2024,2025-02-19 12:00:34.790367,0,0,0,0,
141488,2024,2025-02-19 12:00:34.790367,0,0,0,0,
220630,2024,2025-02-19 12:00:34.790367,84,3,0,87,96.55
220667,2024,2025-02-19 12:00:34.790367,77,8,2,87,88.51
229112,2024,2025-02-19 12:00:34.790367,25,0,0,25,100.0
122974,2024,2025-02-19 12:00:34.790367,82,0,5,87,94.25
204395,2024,2025-02-19 12:00:34.790367,71,5,11,87,81.61
122158,2024,2025-02-19 12:00:34.790367,81,6,0,87,93.1
229259,2024,2025-02-19 12:00:34.790367,23,0,0,23,100.0
160604,2024,2025-02-19 12:00:34.790367,59,1,1,61,96.72
204406,2024,2025-02-19 12:00:34.790367,87,0,0,87,100.0
161440,2024,2025-02-19 12:00:34.790367,85,1,1,87,97.7
204524,2024,2025-02-19 12:00:34.790367,79,3,5,87,90.8
73486,2024,2025-02-19 12:00:34.790367,81,6,0,87,93.1
160601,2024,2025-02-19 12:00:34.790367,71,14,2,87,81.61
226075,2024,2025-02-19 12:00:34.790367,0,0,0,0,
89536,2024,2025-02-19 12:00:34.790367,0,0,0,0,
220533,2024,2025-02-19 12:00:34.790367,84,3,0,87,96.55
204390,2024,2025-02-19 12:00:34.790367,82,4,1,87,94.25
220580,2024,2025-02-19 12:00:34.790367,69,17,1,87,79.31
221338,2024,2025-02-19 12:00:34.790367,85,0,2,87,97.7
220586,2024,2025-02-19 12:00:34.790367,84,0,3,87,96.55
220532,2024,2025-02-19 12:00:34.790367,83,0,4,87,95.4
220626,2024,2025-02-19 12:00:34.790367,83,4,0,87,95.4
204567,2024,2025-02-19 12:00:34.790367,78,6,3,87,89.66
74084,2024,2025-02-19 12:02:57.951467,87,0,0,87,100.0
115200,2024,2025-02-19 12:02:57.951467,26,0,0,26,100.0
74161,2024,2025-02-19 12:02:57.951467,82,3,2,87,94.25
221378,2024,2025-02-19 12:02:57.951467,85,2,0,87,97.7
220606,2024,2025-02-19 12:02:57.951467,86,1,0,87,98.85
205865,2024,2025-02-19 12:02:57.951467,84,0,2,86,97.67
225386,2024,2025-02-19 12:02:57.951467,29,6,0,35,82.86
178989,2024,2025-02-19 12:02:57.951467,55,6,0,61,90.16
153423,2024,2025-02-19 12:02:57.951467,74,3,10,87,85.06
73801,2024,2025-02-19 12:02:57.951467,85,0,2,87,97.7
175765,2024,2025-02-19 12:02:57.951467,3,0,0,3,100.0
221329,2024,2025-02-19 12:02:57.951467,0,0,0,0,
220543,2024,2025-02-19 12:02:57.951467,87,0,0,87,100.0
73788,2024,2025-02-19 12:02:57.951467,1,0,0,1,100.0
204362,2024,2025-02-19 12:02:57.951467,28,0,2,30,93.33
220694,2024,2025-02-19 12:02:57.951467,80,7,0,87,91.95
220633,2024,2025-02-19 12:02:57.951467,77,8,2,87,88.51
213274,2024,2025-02-19 12:02:57.951467,68,10,6,84,80.95
204489,2024,2025-02-19 12:02:57.951467,45,1,2,48,93.75
220693,2024,2025-02-19 12:02:57.951467,76,5,6,87,87.36
220588,2024,2025-02-19 12:02:57.951467,82,5,0,87,94.25
220613,2024,2025-02-19 12:02:57.951467,87,0,0,87,100.0
220624,2024,2025-02-19 12:02:57.951467,84,2,1,87,96.55
220546,2024,2025-02-19 12:02:57.951467,87,0,0,87,100.0
230767,2024,2025-02-19 12:02:57.951467,0,0,0,0,
141531,2024,2025-02-19 12:02:57.951467,82,2,3,87,94.25
223128,2024,2025-02-19 12:02:57.951467,84,0,2,86,97.67
220641,2024,2025-02-19 12:02:57.951467,83,0,4,87,95.4
165470,2024,2025-02-19 12:02:57.951467,73,6,8,87,83.91
220695,2024,2025-02-19 12:02:57.951467,85,2,0,87,97.7
204480,2024,2025-02-19 12:02:57.951467,87,0,0,87,100.0
160629,2024,2025-02-19 12:02:57.951467,87,0,0,87,100.0
163321,2024,2025-02-19 12:02:57.951467,82,1,0,83,98.8
204525,2024,2025-02-19 12:02:57.951467,81,4,2,87,93.1
178945,2024,2025-02-19 12:02:57.951467,3,0,0,3,100.0
220644,2024,2025-02-19 12:02:57.951467,82,3,2,87,94.25
220620,2024,2025-02-19 12:02:57.951467,81,4,2,87,93.1
73806,2024,2025-02-19 12:02:57.951467,37,15,2,54,68.52
74371,2024,2025-02-19 12:02:57.951467,84,0,3,87,96.55
178887,2024,2025-02-19 12:02:57.951467,86,0,1,87,98.85
73604,2024,2025-02-19 12:02:57.951467,62,0,1,63,98.41
160635,2024,2025-02-19 12:02:57.951467,49,12,1,62,79.03
204535,2024,2025-02-19 12:02:57.951467,82,4,1,87,94.25
220631,2024,2025-02-19 12:02:57.951467,85,1,1,87,97.7
204416,2024,2025-02-19 12:02:57.951467,82,5,0,87,94.25
160621,2024,2025-02-19 12:02:57.951467,1,0,0,1,100.0
204387,2024,2025-02-19 12:02:57.951467,87,0,0,87,100.0
220621,2024,2025-02-19 12:02:57.951467,86,1,0,87,98.85
220618,2024,2025-02-19 12:02:57.951467,72,15,0,87,82.76
220713,2024,2025-02-19 12:02:57.951467,84,1,2,87,96.55
226837,2024,2025-02-19 12:05:22.406012,79,3,5,87,90.8
73808,2024,2025-02-19 12:05:22.406012,4,0,0,4,100.0
178933,2024,2025-02-19 12:05:22.406012,86,1,0,87,98.85
204557,2024,2025-02-19 12:05:22.406012,87,0,0,87,100.0
74356,2024,2025-02-19 12:05:22.406012,73,5,9,87,83.91
204360,2024,2025-02-19 12:05:22.406012,77,10,0,87,88.51
220579,2024,2025-02-19 12:05:22.406012,87,0,0,87,100.0
227310,2024,2025-02-19 12:05:22.406012,16,0,0,16,100.0
204425,2024,2025-02-19 12:05:22.406012,0,0,0,0,
220569,2024,2025-02-19 12:05:22.406012,82,2,3,87,94.25
220651,2024,2025-02-19 12:05:22.406012,76,10,1,87,87.36
104552,2024,2025-02-19 12:05:22.406012,83,3,1,87,95.4
220643,2024,2025-02-19 12:05:22.406012,0,0,0,0,
220575,2024,2025-02-19 12:05:22.406012,67,12,8,87,77.01
178946,2024,2025-02-19 12:05:22.406012,81,4,2,87,93.1
178947,2024,2025-02-19 12:05:22.406012,80,7,0,87,91.95
92776,2024,2025-02-19 12:05:22.406012,74,7,6,87,85.06
204534,2024,2025-02-19 12:05:22.406012,81,5,1,87,93.1
230177,2024,2025-02-19 12:05:22.406012,27,0,0,27,100.0
220682,2024,2025-02-19 12:05:22.406012,87,0,0,87,100.0
204464,2024,2025-02-19 12:05:22.406012,75,10,2,87,86.21
220598,2024,2025-02-19 12:05:22.406012,85,2,0,87,97.7
220552,2024,2025-02-19 12:05:22.406012,85,1,1,87,97.7
220560,2024,2025-02-19 12:05:22.406012,61,0,2,63,96.83
220597,2024,2025-02-19 12:05:22.406012,86,1,0,87,98.85
220684,2024,2025-02-19 12:05:22.406012,73,10,4,87,83.91
160976,2024,2025-02-19 12:05:22.406012,78,7,2,87,89.66
178934,2024,2025-02-19 12:05:22.406012,85,2,0,87,97.7
157130,2024,2025-02-19 12:05:22.406012,79,8,0,87,90.8
223398,2024,2025-02-19 12:05:22.406012,32,2,0,34,94.12
160610,2024,2025-02-19 12:05:22.406012,85,2,0,87,97.7
74376,2024,2025-02-19 12:05:22.406012,83,4,0,87,95.4
204396,2024,2025-02-19 12:05:22.406012,75,3,9,87,86.21
74283,2024,2025-02-19 12:05:22.406012,85,2,0,87,97.7
137070,2024,2025-02-19 12:05:22.406012,47,0,8,55,85.45
141555,2024,2025-02-19 12:05:22.406012,66,19,2,87,75.86
160591,2024,2025-02-19 12:05:22.406012,71,7,9,87,81.61
178992,2024,2025-02-19 12:05:22.406012,81,3,3,87,93.1
91228,2024,2025-02-19 12:05:22.406012,81,0,6,87,93.1
160569,2024,2025-02-19 12:05:22.406012,80,7,0,87,91.95
220601,2024,2025-02-19 12:05:22.406012,65,12,10,87,74.71
160518,2024,2025-02-19 12:05:22.406012,84,1,2,87,96.55
74043,2024,2025-02-19 12:05:22.406012,75,7,5,87,86.21
224333,2024,2025-02-19 12:05:22.406012,85,1,1,87,97.7
74044,2024,2025-02-19 12:05:22.406012,57,4,0,61,93.44
182146,2024,2025-02-19 12:05:22.406012,19,1,0,20,95.0
220564,2024,2025-02-19 12:05:22.406012,53,11,0,64,82.81
220660,2024,2025-02-19 12:05:22.406012,79,7,1,87,90.8
230768,2024,2025-02-19 12:05:22.406012,0,0,0,0,
220536,2024,2025-02-19 12:05:22.406012,84,3,0,87,96.55
204559,2024,2025-02-19 12:07:33.322546,54,7,1,62,87.1
160632,2024,2025-02-19 12:07:33.322546,78,8,1,87,89.66
220558,2024,2025-02-19 12:07:33.322546,85,2,0,87,97.7
204517,2024,2025-02-19 12:07:33.322546,83,4,0,87,95.4
160592,2024,2025-02-19 12:07:33.322546,82,2,3,87,94.25
220592,2024,2025-02-19 12:07:33.322546,80,7,0,87,91.95
